11111111111111111111111111
10000000M0000000000EPC0001
10000000MC0000000000000001
1C00000000000000C000000001
1000000000000C00000C000001
10000000000000000000000001
11111111111111111111111111